Gs^Fms, Gs^Fms, Gs^Fms, Gs^Fds, Gs, Gs^Eff, Re^Eff, Gs, Ce, Ce, Gs^Es, Re, Rr^Es, Re, Ce, Gg^Fms, Gg^Fms, Gg^Fms, Gs^Fds, Gs^Fds, Gg, Gg^Fms, Gs^Fds, Gs^Fds, Gs^Fds, Gs^Fds
Gs^Fp, Gs^Fms, Gs^Fp, Gd, Gs^Eff, Re^Eff, Re^Gvs, Re^Gvs, Ce, Gs, Gs^Vh, Rr, Gs^Vh, Ce, Gg^Fms, Gg^Fms, Gs^Fds, Gg^Fms, Gg^Fms, Gg, Gg^Fms, Gs^Fds, Gs^Fms, Gs^Fms, Gs^Fms, Gs^Fms
Gs^Fp, Gs, Re^Eff, Gd^Eff, Re^Gvs, Re^Gvs, Re^Gvs, Re^Es, Gs, Ce, Ce, Rr^Es, Ce, Ce, Gg^Fms, Gg^Fms, Gs^Fds, Gg^Fms, Gg^Fp, Gg^Fms, Gs^Fds, Gs^Fms, Gs^Fms, Gs^Fms, Gs, Gg
Re^Eff, Re^Eff, Re, Re^Gvs, Re^Gvs, Re^Gvs, Re^Gvs, Re^Wm, Re^Gvs, Gs, Gg^Es, Rr, Gg, Gs^Es, Gs, Gg^Fp, Gg^Em, Gg^Fms, Gg^Fp, Gs^Fds, Gg^Fp, Gs^Em, Gs^Fms, Gs^Fms, Gs^Fms, Gs^Fms
Gs, Re^Eff, Re^Eff, Re^Gvs, Re^Gvs, Re^Gvs, Re^Gvs, Re^Gvs, Gs, Re, Re, Rr, Gg^Em, Gg^Fp, Gg^Efm, Gs, Gg^Em, Gg^Emf, Gs^Fms, Gs^Fds, Gg^Efm, Gs^Fds, Gs^Fms, Gs^Fds, Gs^Fds, Gs^Fds
Gg^Efm, Gg^Efm, Gg^Efm, Re^Eff, Gd, Re, Re^Gvs, Re, Gs^Fmw, Gs, Re, Gg, Gg^Fp, Gg^Fms, Gg^Fms, Gg^Fp, Gg^Fms, Gg^Fp, Gg^Fp, Gs^Fds, Gs^Fms, Gs^Fds, Gs^Fms, Gs^Fms, Gs^Fms, Gs^Fms
Gs^Fp, Gs^Fp, Gs^Fp, Gs, Gs^Fp, Re^Es, Gs, Gs, Re, Gg^Efm, Gs^Fmw, Gg, Gg^Efm, Gs^Fms, Gs^Fds, Gs^Fms, Gg^Fds, Gg^Fp, Gs^Fms, Gs^Fms, Gg^Fp, Gs^Fms, Gg^Fms, Gg^Fms, Gg, Gg
Gs^Fms, Gs^Fms, Gs^Fms, Gs, Gg^Fp, Gg^Em, Gs^Fmw, Re, Gs^Fmw, Gs^Fp, Gs^Fp, Gg^Em, Gs^Fp, Gg^Fms, Gs^Fms, Gg^Fds, Gs^Fds, Rb^Vh, Gg, Gg^Fp, Gs^Fms, Gg^Fp, Gg^Fms, Gg^Fms, Gg^Fms, Gg^Fms
Gg, Gg, Gg, Gs^Fms, Gg^Fds, Gg^Fp, Gg^Fds, Rr, Rr, Gs^Fms, Gg^Em, Gs^Fms, Gs^Fms, Gs^Fds, Gs^Fms, Gs^Fms, Gs^Fms, Gs^Fp, Gg^Efm, Gg, Gs^Fms, Gs^Fms, Gs^Fms, Gs^Fms, Gs^Fms, Gs^Fms
Gg, Gg, Gg, Gs^Fp, Gg^Em, Gs^Fms, Gs^Fds, Gs^Fms, Gs^Fms, Gs, Re, Gs^Fp, Gs^Fp, Gs^Fms, Gs^Fms, Gs^Fp, Gg, Gg, Gs^Fms, Gg, Gs^Fms, Gs^Fp, Gll^Em, Gg, Gg, Gg
Ce, Ce, Re^Es, Gs, Gs, Gs^Fp, Gs^Fp, Gg^Efm, Gs^Fp, Gs^Fms, Gs^Fp, Gg, Gg, Gs^Fms, Rb^Vh, Gs^Fp, Gs^Em, Gs^Fp, Gs^Fms, Gll^Fp, Gs^Fms, Gs^Fp, Gs^Fms, Gs^Fds, Gs^Fds, Gs^Fds
Re, Re, Re, Re, Re, Gs^Fp, Gg^Em, Gs^Fmw, Gs^Fms, Gs^Fms, Gs, Re, Gg, Gs^Fp, Gs, Gs, Gs, Gs^Fms, Gs^Fp, Gs^Fms, Gll^Fp, Gll^Vht, Gs^Fmw, Gs^Fmw, Gs^Fmw, Gs^Fmw
Gg^Es, Gg^Es, Gg^Es, Gs, Gg, Gs, Re^Es, Re^Es, Re, Gs^Fmw, Re, Gg, Gs^Es, Gg, Gg, Gs^Efm, Gs, Gg^Es, Gll^Fmw, Gll^Fmw, Gs^Fp, Gs^Fms, Gll^Em, Gs, Gs^Fmw, Gs
Gs^Fp, Gs^Fp, Gs^Fp, Gs^Fmw, Gg^Efm, Gs^Fmw, Gs^Fms, Gs^Fp, Gg, Re, Gs^Fp, Gg^Fmw, Gg^Fms, Gs^Fmw, Gg^Em, Gs^Fmw, Gs, Gs, Gs^Efm, Gs^Fmw, Gs^Fmw, Gs^Fmw, Gll^Fmw, Gll^Emf, Gll^Em, Gs^Fmw
Gs^Fp, Gs^Fp, Gs^Fp, Gs^Fp, Gs^Fp, Gs^Fms, Gs^Fms, Gs^Fp, Re^Es, Re, Rp, Gs^Fp, Gg^Fms, Gs^Fp, Gg, Gs^Em, Gll^Fdw, Gs^Fmw, Gll^Fp, Gll^Fp, Gs^Fp, Gll^Fmw, Gll^Fdw, Gll, Gll^Fdw, Gs^Fmw
Ww, Ww, Ww, Ww^Ewf, Ww, Gs^Fp, Gg^Vl, Re, Gs^Efm, Gs^Fmw, Gs, Rp, Gs^Fp, Gs^Fmw, Gs^Efm, Gs, Gs^Fmw, Gs^Fmw, Gll^Fmw, Gs^Fmw, Gs^Fdw, Gs^Em, Gs, Gs, Gs^Efm, Gs
Gg^Efm, Gg^Efm, Gg^Efm, Gg^Fp, Ww, Ww^Ewl, Gs^Fmw, Gg, Gs^Fp, Gs, Gs^Fp, Re, Gs, Gs^Em, Gs^Vc, Gll^Fp, Gs^Fp, Gs^Fmw, Gll^Fp, Gs^Fdw, Gd^Fmw, Gs^Efm, Hh^Fdw, Hh^Fmw, Hh, Gs
Gg^Fp, Gg^Fp, Gg^Fp, Ww^Ewl, Ww^Ewf, Gs^Fmw, Gg^Fp, Gg^Em, Gs^Fms, Gs^Fmw, Gs^Fmw, Re^Es, Gll^Fp, Gs^Fp, Gs^Fp, Gs^Fmw, Gd^Fp, Gd^Fmw, Gd^Em, Gd^Fmw, Gs^Fmw, Gd^Fmw, Gs^Fdw, Gs^Fdw, Gs^Em, Gs^Fdw
Gg^Fp, Gg^Fp, Gg^Fp, Gg, Gs^Fdw, Gs^Efm, Gg^Fp, Gs^Fp, Gg^Fms, Gs^Fp, Gs, Re, Gll^Fp, Gs^Fp, Gd^Fmw, Gll^Fp, Gd^Fmw, Gd^Fp, Gs^Em, Gd^Fmw, Gd^Fp, Hh^Fmw, Hhd^Fmw, Hhd^Fmw, Hh^Fmw, Hhd^Fmw
Gs^Fp, Gs^Fp, Gs^Fp, Gll^Fmw, Gs, Gs^Em, Gs^Emf, Gg^Fmw, Gs^Fdw, Gs^Fp, Gs, Rp, Re, Gd^Fmw, Re^Fdw, Gd^Fdw, Rd^Es, Gd, Gd^Fdw, Hhd^Fmw, Hhd^Es, Hhd^Fp, Gd^Fmw, Hh^Fmw, Hhd^Fmw, Gs^Fmw
Gll, Gll, Gll, Gs^Fp, Gs^Fmw, Gs^Fdw, Gs^Fmw, Gs^Fp, Gll^Fmw, Gs^Fdw, Rp, Rp, Gs^Fp, Gd, Rd^Es, Hhd, Rd, Gd, Ds, Rd, Hhd^Fmw, Hhd^Fmw, Hhd^Em, Hh^Fmw, Hhd^Fmw, Hh
Gs^Fp, Gs^Fp, Gs^Fp, Gs^Fp, Gll^Fmw, Gs^Fmw, Gll^Fmw, Gs^Fmw, Gs^Em, Gs^Fp, Re^Es, Gs^Efm, Gs^Fmw, Hh, Hh^Fmw, Hhd^Fmw, Hhd^Fdw, Ds^Edp, Rd^Es, Rd^Edp, Hd^Es, Hhd^Fmw, Hhd^Fdw, Hhd, Hd, Hhd
Ww, Gs^Fp, Ww, Gs^Fmw, Gll^Em, Gll^Fdw, Gll^Fmw, Gll^Fmw, Gs^Fdw, Gs, Gs^Es, Gs^Fp, Gs^Fmw, Hh, Gd^Fmw, Gd^Fdw, Ds, Ds^Esd, Dd^Esd, Hhd, Hd^Edp, Dd^Fdw, Hd, Hhd, Dd^Fdw, Hd
Ww, Ww, Ww, Ww^Ewl, Gll, Gll^Vht, Ww^Ewf, Gll^Fp, Ww, Re, Gg^Fp, Gll^Fmw, Gs^Fp, Gd^Fmw, Ww, Rd^Fdw, Ww, Ww, Ww, Dd, Hd, Dd, Ds^Esd, Ds, Ds, Ds
Gll^Fp, Gll^Fp, Gll^Fp, Ww, Ww, Ww, Ww, Ww, Ww, Ww^Bw|, Ww, Gs^Fp, Ww^Ewl, Ww^Ewl, Gs^Fmw, Ww, Ww, Ww, Ww, Ww, Ww, Ww, Ww, Ww, Ww, Ds
Ww, Ww, Ww, Ww, Ww, Ww, Gll^Fdw, Gll^Fmw, Gll^Fmw, Rp, Rp, Ww, Gs^Fmw, Gs^Fp, Gs^Fmw, Gll^Fdw, Gs^Fdw, Ww^Ewf, Gd^Fdw, Ww, Ww, Ww, Ww, Ww, Ww, Ww
Gs^Fdw, Gs^Fdw, Gs^Fmw, Gll, Ww, Gll, Gll, Gs^Fmw, Gll^Fp, Gll^Fdw, Re, Gll^Fdw, Gll^Fmw, Gs^Fp, Gd^Fp, Gll^Fmw, Gll^Fmw, Gd^Fdw, Hh, Hh^Es, Gd^Es, Gd^Fdw, Hh, Hhd, Hh, Hh
Gll^Fmw, Gll^Fmw, Gs^Fmw, Gll^Em, Ww^Ewl, Ww^Ewf, Gs^Fmw, Gs^Fp, Gs^Vc, Gs^Fp, Gs^Fp, Re, Gs^Em, Gs^Fdw, Gd^Fmw, Gd^Es, Gd^Fmw, Gd^Fmw, Hhd, Hhd, Hh^Fmw, Hh, Hhd^Fdw, Hhd, Hhd^Fmw, Hhd^Fp
Gd^Fp, Gd^Fp, Gd^Fp, Gd^Fmw, Gd^Fp, Gll^Fp, Gs^Fmw, Gll^Fdw, Gll^Fp, Gs^Fmw, Gs^Fdw, Re, Re, Gll^Fmw, Gd^Fp, Gll^Fp, Gd^Fp, Hhd, Hh^Fmw, Hhd, Hhd^Edb, Hhd^Edb, Hhd^Fmw, Hhd^Fp, Hhd^Fp, Hhd^Fp
Gll, Gll^Fmw, Gll, Gd^Fp, Gs^Vl, Gs^Fp, 1 Re, Gs^Fp, Re^Es, Gs^Fmw, Re, Re, Gll^Fp, Gs^Fp, Gll^Em, Gd^Fmw, Hh^Fmw, Hh^Fmw, Hhd^Fmw, Hhd^Fp, Gs^Fp, Hhd^Fdw, Hhd^Edb, Hhd, Hhd, Hhd
Gs^Fmw, Gd^Fp, Gd^Fp, Gll^Em, Gll^Em, Gll, Gll^Fmw, Re^Es, Gll^Fdw, Gll, Gs^Efm, Gs^Em, Gll^Fmw, Gs^Fmw, Gll^Emf, Gll^Fdw, Hh^Fmw, Hh^Fp, Gs^Fmw, Hhd, Hh^Fmw, 2 Hhd^Edb, Hhd^Fp, Hhd^Fdw, Hhd^Fdw, Hhd^Fdw
Gs^Fmw, Gs^Fmw, Gs^Fp, Gll^Fp, Gs, Gs, Gs^Fp, Gll^Fmw, Gll^Fmw, Gll^Fp, Gll^Fp, Gs^Fp, Gs^Fp, Gs^Fmw, Gd^Fp, Gd, Hh, Hh, Gs^Fds, Hh, Hh^Fds, Hh, Hh^Fms, Hh^Fms, Hh^Fms, Hh^Fms
