Ww, Ww, Ww, Ww, Ww, Wo, Wo, Wo, Wo, Wo, Wo, Wo, Wo, Wo, Wo, Wo, Wo, Wo, Wo, Wo, Wo, Wo, Wo, Wo, Wo, Wo, Wo, Wo, Wo, Ww
Ds, Ww, Wwr, Ww, Wwr, Wo, Wo, Wo, Wo, Wo, Wo, Wo, Wo, Wo, Wo, Wo, Wo, Wo, Wo, Wo, Wo, Wo, Wo, Wo, Wo, Wo, Wo, Wo, Wo, Wo
Gs, Ds, Ds, Wwr, Ds, Wwr, Wwr, Wo, Wo, Wo, Wo, Wo, Wo, Wo, Wo, Wo, Wo, Wo, Wo, Wo, Wo, Wo, Wo, Wo, Wo, Wo, Wo, Wo, Wo, Wo
Gs, Gs, Gg^Vc, Ds, Gs, Ds, Ww, Ww, Ww, Ww^Vm, Wwr, Wo, Wo, Wo, Wo, Wo, Wo, Wo, Wo, Wo, Wo, Wo, Wwr, Wwr, Wwr, Ww, Ww^Vm, Wo, Wo, Wo
Gg, Gg, Gg, Gg, Gg, Ds, Ds, Ww, Ww, Wwr, Wwr, Wwr, Wo, Wo, Wo, Wo, Wo, Wo, Wo, Wo, Wo, Ww, Cme, Cme, Cme, Ww, Ww, Wo, Wo, Wo
Hh, Hh, Hh, Gg, Gg, Gs, Gs, Ww, Ww, Ww, Ww, Wwr, Wwr, Wo, Wo, Wo, Wo, Wo, Wo, Wo, Ww, Wwr, Cme, 1 Kme, Cme, Wwr, Ww, Wo, Wo, Wo
Mm^Xm, Mm, Mm, Hh^Fp, Gs^Fms, Gg, Gg, Ds, Ww, Ds, Ww, Ww, Ww, Wo, Wo, Wo, Wo, Wo, Wo, Wo, Ww, Wwr, Wwr, Cme, Wwr, Ww, Wo, Wo, Wo, Wo
Mm^Xm, Mm^Xm, Mm, Hh^Fp, Hh, Gg, Gs, Gs, Ds, Ww, Dd^Vda, Wwr, Wwr, Wo, Wo, Wo, Wo, Wo, Wo, Wo, Wo, Ww, Ww, Wwr, Wo, Wo, Wo, Wo, Wo, Wo
Mm^Xm, Mm^Xm, Ww, Mm, Re^Gvs, Re^Gvs, Re^Gvs, Gg, Ww, Ww, Dd, Dd, Wwr, Ww, Ww, Wo, Wo, Wo, Wo, Wo, Wo, Wo, Wo, Wo, Wo, Wo, Wo, Wo, Wo, Wo
Mm^Xm, Mm, Mm, Gg^Ve, Re^Gvs, Re^Gvs, Gg, Gs, Ww, Dd, Hd, Dd, Dd, Wwr, Ww, Wwr, Wwr, Wo, Wo, Wo, Wo, Wo, Wo, Wo, Wo, Wo, Wo, Wo, Wo, Wo
Hh, Mm^Xm, Mm, Mm, Ww, Gg, Ww, Ww, Gs^Ft, Gs^Ft, Dd, Dd, Dd, Wwr, Ww, Wwr, Wwr, Wwr, Wo, Wo, Wo, Wo, Wo, Wo, Wo, Wo, Wo, Wo, Wo, Wo
Mm^Xm, Hh, Ww, Ww, Gg, Ww, Gs^Fp, Ww, Dd, Dd, Gs^Ft, Dd, Dd, Dd, Dd, Ww, Ww, Wwr, Ww, Wwr, Ww^Vm, Wo, Wo, Wo, Wo, Wo, Wo, Wo, Wo, Wo
Mm^Xm, Mm^Xm, Mm^Xm, Mm, Gs^Fp, Gs^Fp, Gs^Fds, Ww, Ww^Bw|, Ww, Ww, Gs^Ft, Ss, Dd, Dd, Dd, Ww, Ww, Ww, Wwr, Wo, Wo, Wo, Wo, Wo, Wo, Wo, Wo, Wo, Wo
Mm^Xm, Mm^Xm, Mm^Xm, Mm^Xm, Mm, Gs^Fms, Gs^Fms, Gg, Rd, Hh, Mm, Ww, Mm, Gs^Ft, Dd^Vda, Dd, Ww, Ww, Ww, Wwr, Wo, Wo, Wo, Wo, Wo, Wo, Wo, Wo, Wo, Wo
Mm^Xm, Mm^Xm, Mm, Mm, Hh^Vhh, Gs^Fp, Rd, Rd, Gs^Fp, Hh^Fp, Mm, Mm^Xm, Gs, Gs, Ds, Ds, Ds, Ww, Wwr, Wwr, Wo, Wo, Wo, Wo, Wo, Wo, Wo, Wo, Wo, Wo
Hh, Ww, Ww, Mm, Hh^Fp, Rd, Gs, Gs^Fp, Gs^Fp, Hh^Fp, Gg^Efm, Mm, Gs, Ds, Ds, Ds, Ww, Ww, Wwr, Wwr, Wo, Wo, Wo, Wo, Wo, Wo, Wo, Wo, Wo, Wo
Mm^Xm, Ww, Mm, Ww, Ww, Gg, Ww, Gs, Gg, Gg^Efm, Ss, Gg^Efm, Gs, Dd, Ds, Ds, Ww, Ww, Wwr, Wwr, Wo, Wo, Wo, Wo, Wo, Wo, Wo, Wo, Wo, Wo
Mm^Xm, Mm^Xm, Mm^Xm, Mm, Hh^Fp, Ww, Gs^Fp, Ww, Ww, Ss, Ch, Ss, Ww, Dd, Ds, Ds, Ww, Ww, Wwr, Wwr, Wo, Wo, Wo, Wo, Wo, Wo, Wo, Wo, Wo, Wo
Mm^Xm, Mm^Xm, Mm, Mm, Hh^Fp, Gs^Fp, Gs^Fp, Gs, Ww, Ch, 2 Kh, Ch, Ds, Ww, Ds, Ww, Ww, Ww, Ww, Ww, Wo, Wo, Wo, Wo, Wo, Wo, Wo, Wo, Wo, Wo
Mm^Xm, Mm^Xm, Ww, Ww, Ww, Ww, Ww, Gs, Ww, Ch, Ch, Ch, Ds, Ww, Ww, Ww, Wwr, Ww, Wo, Wo, Wo, Wo, Wo, Wo, Wo, Wo, Wo, Wo, Wo, Wo
Ww, Ww, Gs^Fms, Gs^Fp, Gg, Gs^Fms, Gs, Ww, Ww, Ds, Ds, Ds, Ww, Ww, Wwr, Wwr, Wwr, Wwr, Wo, Wo, Wo, Wo, Wo, Wo, Wo, Wo, Wo, Wo, Wo, Wo
Hh, Hh^Vhh, Rd, Gg, Gs, Gs, Ds, Ds, Ds, Ww, Ww, Ww, Wwr, Ww, Wwr, Wwr, Ww, Wo, Wo, Wo, Wo, Wo, Wo, Wo, Wo, Wo, Wo, Wo, Wo, Wo
Gs^Fp, Gs^Fp, Rd, Gs^Fp, Rd, Gs, Gs^Vht, Ds, Wwr, Wwr, Wwr, Wwr, Wwr, Wwr, Ww, Ww, Wo, Wo, Wo, Wo, Wo, Wo, Wo, Wo, Wo, Wo, Wo, Wo, Wo, Wo
Gg, Gg, Gs, Rd, Gs, Rd, Dd, Wwr, Ww, Ww, Ww, Wwr, Wo, Ww, Wo, Ww, Wo, Wo, Wo, Wo, Wo, Wo, Wo, Wo, Wo, Wo, Ww, Wo, Wo, Wo
Ds, Gs, Ww, Dd, Dd, Dd, Ww, Ww, Wo, Wo, Wo, Wo, Wo, Wo, Wo, Wwr, Wwr, Wwr, Ww, Wo, Wo, Wo, Wo, Wo, Wo, Ww, Ww^Vm, Wo, Wo, Wo
Ww, Ds, Ww, Ww, Ww, Ww, Wwr, Wo, Wo, Wo, Wo, Wo, Wo, Wo, Wo, Wo, Wo, Ww^Vm, Ww, Wo, Wo, Wo, Wo, Wo, Wo, Ww, Wo, Wo, Wo, Wo
Ww, Ww, Ww, Ww, Wwr, Wwr, Wwr, Wo, Wo, Wo, Wo, Wo, Wo, Wo, Wo, Wo, Wo, Ww, Wo, Wo, Wo, Wo, Wo, Wo, Wo, Wo, Wo, Wo, Wo, Wo
Wo, Wo, Wo, Wo, Wo, Wwr, Ww^Vm, Wo, Wo, Wo, Wo, Wo, Wo, Wo, Wo, Wo, Wo, Wo, Wo, Wo, Wo, Wo, Wo, Wo, Wo, Wo, Wo, Wo, Wo, Wo
Wo, Wo, Wo, Wo, Wo, Wo, Wo, Wo, Wo, Wo, Wo, Wo, Wo, Wo, Wo, Wo, Wo, Wo, Wo, Wo, Wo, Wo, Wo, Wo, Wo, Wo, Wo, Wo, Wo, Wo
Wo, Wo, Wo, Wo, Wo, Wo, Wo, Wo, Wo, Wo, Wo, Wo, Wo, Wo, Wo, Wo, Wo, Wo, Wo, Wo, Wo, Wo, Wo, Wo, Wo, Wo, Wo, Wo, Wo, Wo
