Wo, Wo, Wwrg, Mm, Mm, Mm, Mm, Mm, Hh, Gll^Fdw, Hh^Fmw, Hh^Fp, Gll^Fmw, Gd, Re^Es, Gg, Hh, Hh, Mm, Mm, Hh^Fmw, Mm, Mm, Mm, Mm, Hh, Hh^Es, Re, Re, Re, Hh, Mm, Mm, Mm
Wog, Wo, Wo, Mm, Wwg^Ewl, Mm, Mm, Mm, Sm^Emf, Gll^Fdw, Gll^Fdw, Hh^Fp, Gll^Fmw, Re^Edb, Ce, Gd^Edpp, Gd^Es, Hh^Fmw, Mm, Mm, Hh^Fp, Mm, Mm, Mm, Hh^Fp, Hh, Re, Re^Es, Hh, Gs, Hh^Fmw, Mm, Hh^Em, Mm
Wog, Wo, Wo, Wo, Wog, Mm, Mm, Hh, Sm^Em, Sm^Em, Gll^Fmw, Re^Vct, Re^Edb, Ce^Es, 2 Ke, Ce^Edb, Re^Edb, Gs^Em, Gll^Fmw, Mm, Hh^Vhh, Gll^Fp, Hh^Fmw, Gll^Fdw, Gd, Re, Gd^Edpp, Gd, Hh^Fmw, Hh^Fmw, Gs^Fms, Hh^Vhh, Hh^Fds, Hh^Es
Wog, Wog, Wo, Wog, Wog, Mm, Hh, Mm, Sm^Em, Ss^Edb, Ss^Em, Ss, Re^Edb, Ce^Edb, Ce^Edb, Ce^Edb, Re^Es, Gll^Fdw, Hh^Fmw, Gd^Em, Gll^Fp, Gd^Em, Re, Re, Re, Re^Es, Re, Gd^Es, Gs^Em, Gs^Fp, Hh^Fms, Gs^Fds, Gs^Fds, Mm
Mm, Wo, Wo, Wo, Wog, Mm, Mm, Ss^Emf, Ss^Em, Rb, Sm^Edb, Gll^Fmw, Sm, Gd^Es, Gd^Edpp, Gd^Edb, Gll^Fmw, Re, Re^Vct, Hh^Fp, Gll^Fp, Re^Es, Re^Es, Wwf, Wwg^Ewf, Wwg^Ewl, Re, Gd^Edpp, Hh^Fmw, Gs^Fp, Hh^Fp, Hh^Fms, Gs^Efm, Gs^Fms
Mm, Wwrg, Wwrg, Wog, Wog, Wwg^Ewl, Sm, Sm^Em, Wwg, Ss, Wwg^Edb, Sm, Wo, Wwg^Edb, Wwg, Wwg, Wwg, Wwg, Re^Edb, Re, Re, Re, Wwf^Es, Wwf, Re^Es, Wwf, Re^Es, Re, Gs, Gs^Em, Gg^Em, Gs^Fp, Hh, Gg^Em
Mm, Mm, Wog, Wog, Wog, Wog, Wog, Wog, Wog, Wwrg, Wwg, Wo, Wo, Wo, Wo, Wo, Wwg^Edb, Wwg, Cer^Edb, Cer^Edb, Wwg, Gll^Em, Wwg, Wwf, Wwf, Wwf, Wwf, Wwf^Es, Wwf, Gg^Efm, Wwg^Ewf, Hh^Fp, Wwg^Ewl, Wwg
Mm, Mm, Mm, Wwg^Es, Wog, Wog, Wog, Wog, Wog, Wog, Wo, Wo, Wo, Wo, Wo, Wo, Wo, Wo, Wo, Wo, Wo, Wwg, Wo, Wwg, Wwrg, Wwf^Es, Wwf, Wwf, Wwrg, Wwg^Ewl, Wo, Wwg, Wo, Wo
Mm, Mm, Hh, Wwg^Ewl, Wwg^Ewl, Wog, Wwg, Wog, Wog, Wo, Wo, Wo, Wo, Wo, Wo, Wo, Wo, Wo, Wo, Wo, Wo, Wo, Wo, Wwrg, Wwrg, Wwf, Wwg, Wwf, Wwf, Wo, Wo, Wo, Wo, Wo
Mm, Mm, Hh^Fmw, Hh, Re^Es, Wwg^Bw/, Wwg, Wog, Wo, Gg, Wo, Wo, Wwg, Wo, Wo, Wo, Wo, Wo, Wo, Wo, Wo, Wo, Wo, Wwg, Wwf, Wwg, Wwf^Es, Wwf, Wwrg, Wwg, Wo, Wo, Wo, Wo
Mm, Hh^Fp, Hh^Em, Gs^Fdw, Re^Gvs, Re^Wm, Wwrg, Wwg, Wwg, Wwrg, Wwg, Wwrg, Gs^Efm, Wwg, Re, Wo, Wwrg, Wo, Wo, Wo, Wo, Wo, Wwg, Wwg, Wwf^Es, Wwg, Wwf, Wwf, Wwg, Wwg, Wwg, Wwrg, Re^Es, Wo
Hh^Fmw, Hh^Fmw, Gs^Fdw, Gs^Es, Re^Gvs, Re^Gvs, Re^Es, Wwrg, Wwg^Ewl, Wwg^Ewf, Wwg, Re^Es, Re^Gvs, Re^Gvs, Re^Gvs, Wwrg, Gg, Wwrg, Wo, Wo, Wo, Wwg, Wwrg, Wwf, Wwf, Wwf, Wwf^Efm, Wwf^Ewl, Ce, Wwf, Wwg^Ewl, Wo, Wo, Re^Es
Hh^Em, Gs^Fmw, Gs, Re^Gvs, Re^Gvs, Re^Gvs, Re^Es, Gg^Efm, Gs, Wwg^Ewf, Gs, Wwg^Ewl, Re^Gvs, Re^Gvs, Re^Vc, Gs^Es, Wwg^Ewl, Wwg^Ewl, Wwg, Wwg, Wwg, Wwg, Gg, Ce, Gs^Fmw, Gs^Fdw, Gs, Gs^Es, Re^Es, Re, Wwg, Wwg, Wwg^Ewl, Wwg
Hh^Fp, Hh, Gg^Efm, Re^Es, Gs, Gs, Rp, Chr, Re^Es, Gg^Efm, Gs, Gd, Gd, Re, Gs, Gs, Gs^Fms, Gs, Gd, Wwg^Ewl, Ce, Ce, Ce, Re, Re, Gs^Fdw, Re^Es, Re^Es, Re, Gg^Fmw, Gg^Fmw, Gs^Efm, Gs^Fp, Gg^Efm
Gs^Fmw, Gs^Fp, Gs^Fp, Re, Re, Rr, Rr^Vhc, Rp, Re, Re^Dr, Re^Es, Gd^Es, Gs, Re, Re, Gs^Eff, Gs^Eff, Gs^Fp, Gd, Gd^Es, Gd, 1 Ket, Ce, Gs, Re^Es, Re, Re, Re, Gs^Fdw, Gg^Efm, Gs^Fmw, Gs^Fdw, Gs^Em, Gs^Fp
Gs^Fdw, Gs^Fp, Ww^Ewf, Gg^Fet, Ww^Ewf, Re, Rr^Es, Rp, Gd, Re^Es, Gd, Re^Es, Gd, Gs^Efm, Re, Re^Es, Re, Gg, Re^Es, Re, Re, Gd^Es, Re^Es, Gs^Efm, Re, Re, Gs^Vh, Re, Re, Gg^Fmw, Gg, Gs^Fms, Gs^Fms, Gs^Fds
Gs^Em, Gs^Fdw, Ww, Ww, Rr, Rr, Rr, Gs^Efm, Gs, Gd^Vhr, Re^Es, Re, Re, Re, Gg^Efm, Gd, Gs, Re, Gd, Re, Re^Eff, Re^Eff, Re^Eff, Re^Eff, Gd^Eff, Gd, Gs, Gg^Es, Re^Es, Gs^Efm, Gs^Fms, Gs^Fms, Gs^Fds, Gs^Fds
Gs, Re^Wm, Re^Es, Re, Re^Es, Ch, Ch, Re, Re, Re, Rp, Rp, Re^Dr, Gs, Gs^Fp, Ce, Gs^Fms, Gd^Fmw, Rb^Eff, Re^Eff, Rb^Es, Re, Re^Gvs, Gd^Gvs, Gd^Gvs, Gd^Eff, Re^Eff, Gs, Gs^Fmw, Re, Re, Gll^Fp, Re^Es, Gll^Fp
Gs, Re^Gvs, Re^Gvs, Re, Rr, 3 Kh, Ch, Rr, Re^Es, Rp, Rp^Vhcr, Rp, Chr, Gs^Es, Gs^Fmw, Gs^Fp, Gs^Fmw, Re^Eff, Rb^Eff, Rb^Es, Rb, Re^Es, Re^Gvs, Re^Gvs, Re^Gvs, Re^Gvs, Gd^Gvs, Re^Eff, Re, Re^Es, Gs^Fdw, Re, Gll^Fp, Re^Es
Re^Gvs, Re^Gvs, Re^Gvs, Re, Re^Eff, Rr^Es, Gg, Re, Gs^Em, Re, Rr, Rp, Chr, Gs^Em, Gs^Em, Gs^Fms, Re^Eff, Re^Eff, Re^Gvs, Rb^Vh, Re^Es, Re^Gvs, Re^Wm, Re^Gvs, Re^Gvs, Re^Gvs, Gd^Es, Gs^Vc, Re^Es, Re, Gg^Fmw, Gs^Fp, Gs^Em, Gs
Re^Gvs, Re^Gvs, Re^Gvs, Re^Gvs, Re^Eff, Re^Eff, Gs^Fp, Gg^Efm, Gs^Fmw, Re, Rr^Es, Re^Es, Re^Em, Gs^Fmw, Gs^Fmw, Gs, Gd, Gd^Gvs, Re^Gvs, Rb^Gvs, Re^Gvs, Re^Gvs, Re^Gvs, Re^Gvs, Re^Gvs, Gd, Gd^Es, Gd, Gs^Es, Gs^Eff, Gs^Eff, Gll^Fp, Gll^Emf, Gll^Fp
Gg, Gs, Gs, Re^Eff, Gs^Fmw, Gs^Fmw, Gs^Fp, Gs^Em, Gs^Fms, Gs^Fp, Re, Gs, Gs^Fp, Gs^Fp, Gs^Fp, Gs, Gs, Gd^Gvs, Re^Gvs, Re^Gvs, Re^Gvs, Re^Gvs, Re^Gvs, Re^Gvs, Re^Gvs, Gd, Re^Gvs, Gd, Gs, Gs^Eff, Gll^Fp, Gll^Fp, Gll^Fp, Gll^Fp
