Mm^Qhh, Ww^Qhh, Ww^Qhh, Ww^Qhh, Mm, Hh^Qhhf, Gs^Qhhf, Gll^Qhhf, Gll^Qhhf, Gs^Qhhf, Hh^Qhhf, Gs^Qhhf, Re^Qhhf, Gs^Qhhf, Gll^Qhhf, Rr^Qhh, Rr^Qhh, Gg^Qhh, Hh^Qhhf, Gg^Qhhf, Gll^Qhhf, Gg^Qhh, Wo^Es, Wo, Wo, Mm, Mm, Mm, Mm^Xm, Mm, Mm^Xm, Mm^Xm, Mm^Xm, Mm, Mm, Mm, Hh, Wo, Wo^Edb, Wo, Ww^Es
Hh^Qhh, Mm, Ww, Ww, Gd, Hh, Hh, Gll^Fp, Hh^Fp, Hh^Fds, Hh^Fds, Re^Fms, Gll^Fp, Re^Fms, Rr, Rr^_mh, Gs^Fms, Hh^Vhh, Hh^Fp, Hh^Fp, Gs^Fms, Hh^Qhhf, Rb^Qhh, Wo, Ww^Edt, Hh, Mm, Mm, Mm, Mm, Mm, Mm, Hh, Mm, Mm, Mm, Hh, Ww^Es, Mm, Ww, Mm^Xm
Hh^Qhh, Hh, Wwr, Ww, Ww, Gll^Qhh, Gd, Gs^Fds, Gs^Fds, Hh^Fds, Gs^Vl, Hh^Fds, Gg, Re^Efm, Gs^Vl, Gg^Efm, Gg^Qhh, Gs^Fms, Gg^Qhh, Gg^Qhh, Gg^Qhh, Gs^Fds, Gll^Qhh, Ww, Gll^Feth, Mm, Hh, Mm, Mm, Mm, Hhd, Hhd^Es, Hhd, Mm, Mm, Hh, Mm, Mm, Mm, Mm, Mm^Xm
Hh^Qhh, Ww, Ds, Ww, Ww, Gll^Qhh, Hh^Qhh, Hh, Gg, Gll^Fp, Gg, Gll, Rr, Gg^Efm, Re^Qhh, Re^Qhh, Ww, Gg^Qhh, Ww, Ww, Wwf, Gll^Qhh, Wwf^Edt, Wwf, Gll, Rb, Gg, Hh, Gg, Hh, Hh, Gg^Vhr, Gg, Hh, Hh, Hh, Mm, Mm, Mm, Mm, Mm
Rr^Qhh, Gll, Gd, Ds, Ww, Ww, Gg^Qhh, Hh, Gll^Fp, Gg, Gd, Rp, Gs^Qhhf, Rb^Qhh, Ww, Ww^Es, Wo, Wo, Gll, Gll, Mm, Wwf, Mm, Rb^Em, Gd, Re, Re, Gs, Cer, Gs, Cer, Hh, Mm, Hh, Hh^Vhhr, Hh, Mm, Mm^Xm, Mm^Xm, Mm, Mm
Rr^Qhh, Rr, Gll, Gd^Efm, Ds, Ww, Ww, Gg^Qhh, Gll^Fp, Gll^Fp, Gd^Qhh, Gll^Qhh, Ww, Rb^Qhh, Ww, Wo, Re, Wo^Es, Gll, Hh^Fds, Hh^Fms, Mm, Mm, Mm, Mm, Hh, Hh, Gs^Ecf, Cer, 2 Ker, Cer, Hh, Mm, Mm, Hh, Hhd, Mm, Mm, Mm, Mm^Xm, Mm
Gs^Qhhf, Rr^Qhh, Rrc, Gd, Ds, Ww, Ww, Gg^Qhh, Rp^Qhh, Rrc^Qhh, Ww, Gll^Qhh, Ww, Ww, Wo, Wo, Ww, Gg^Fds, Hh^Fp, Hhd^Fp, Hh^Fms, Mm, Mm, Mm, Hhd^Edb, Mm, Hh, Cer, Hh, Cer, Re, Mm, Mm, Mm, Mm, Hh, Hhd, Hh, Mm, Mm, Mm^Xm
Gs^Qhhf, Gg, Re, Rr, Rr, Ds, Ww^Es, Ww, Rr^Qhh, Wwf, Ww, Wo, Wo, Ww, Gll, Ww, Gg^Fds, Gll^Fds, Hh^Fms, Hh^Fp, Hh, Hh, Hh^Fp, Hh, Hhd, Hh, Mm, Hh, Gg, Re, Gg^Vhr, Rb, Hhd, Mm, Mm, Mm, Mm, Hhd, Hh, Mm^Xm, Mm^Xm
Gs^Qhhf, Gs^Fds, Gs^Fds, Gg, Re, Rr, Re, Ww^Bw/, Ww, Gd^Qhh, Gll^Qhh, Wo, Ww, Gll, Rb^Gvs, Ww^Es, Gg^Fds, Gll^Fmw, Hh^Fds, Hh^Fms, Hh^Vhh, Hh, Gg, Hh, Mm, Hhd, Mm, Hh, Mm, Hh, Hhd, Gll, Re, Hhd, Hh, Mm, Mm, Mm, Mm, Mm, Mm
Gs^Qhhf, Gs^Fds, Gll^Fp, Gd, Rrc, Rr, Ds^Vh, Ds, Ww, Gll^Qhh, Wo, Wo, Ww, Re, Re^Gvs, Wwf, Wwf, Gll, Gll^Fmw, Gll^Fmw, Gs^Fmw, Gg, Hh, Hh, Mm, Mm, Mm, Mm, Hhd, Mm, Mm, Hhd, Hhd, Re, Hh, Hh, Mm, Mm, Mm, Mm, Mm
Gll^Qhhf, Gs^Fds, Gg, Re, Rr, Gg, Gll^Qhh, Ww, Wo, Wo, Ww, Ww, Re, Rb^Gvs, Re^Gvs, Rb^Gvs, Wwf, Gd, Gs, Gs, Gd, Gs, Gll, Hh, Hh, Mm, Mm, Mm, Mm, Mm, Mm, Mm, Mm, Re, Gg, Hh, Hhd, Mm, Mm, Mm, Mm
Gll^Qhhf, Gll^Fp, Gs^Fds, Gs^Vl, Rb^Qhh, Rp, Ch^Qhh, Ww, Ww, Ww, Gg, Ww, Rb^Gvs, Rb^Gvs, Rb^Gvs, Re^Vh, Rb^Gvs, Gs^Gvs, Gg^Eff, Gd, Gg, Gll, Hh, Hh, Mm, Hh, Mm, Hh, Mm, Mm, Hh, Mm, Hhd, Hh, Gg, Re, Hhd, Mm, Mm, Mm, Mm
Gs^Qhhf, Gs^Qhhf, Gs^Qhhf, Gg^Qhh, Ww, Rp^Qhh, Ww^Bsb\, Gg, Ww, Rb, Re^Gvs, Rb^Gvs, Rb^Gvs, Rb^Gvs, Rb^Gvs, Rb^Gvs, Rb^Gvs, Rb^Gvs, Gg^Vwm, Gg^Eff, Gg^Eff, Gg, Gll, Hh^Fds, Hh, Mm, Mm, Hh, Hh, Hh, Hh, Hh, Hhd, Hhd^Edb, Gg, Re, Re^Vhr, Hh, Hh, Mm, Mm
Gs^Fds, Gs^Qhhf, Gg^Qhh, Gs^Qhhf, Wo, Ww, Wo, Ww^Bsb\, Rr, Re^Edt, Re^Vh, Rb^Gvs, Re^Gvs, Re^Gvs, Rb^Gvs, Rb^Gvs, Rb^Gvs, Rb^Gvs, Rb^Eff, Gg^Eff, Gs, Gll^Fmw, Gs^Fms, Gg^Fmw, Hh^Fp, Mm, Hh, Gg, Re, Hh, Gg, Gg, Hh^Vhhr, Hhd, Re, Gg, Gg, Gg, Cer^Edb, Hh, Hh
Gs^Qhhf, Gs^Qhhf, Gs^Qhhf, Ww^Es, Wo, Wo, Wo, Rb, Gg, Gg, Ch, Ch, Re^Gvs, Re^Gvs, Rb^Gvs, Gg, Gg^Eff, Re^Vh, Gg^Eff, Gg^Eff, Gs^Fds, Gll^Fmw, Gs^Fms, Gg, Gg, Hh, Gg, Re, Re, Gg, Re, Gg, Re, Rb, Cer, Cer^Edb, Cer, Gll, Rb, Hh, Gs
Gs^Qhhf, Gg^Qhh, Wo, Wo, Wo, Wo, Gs^Vh, Re, Rr, Gg, Re, 1 Kh, Ch, Re^Gvs, Re^Gvs, Rb^Gvs, Rb^Gvs, Gg^Eff, Gg, Gg, Re^Vh, Gg, Re, Gs, Re, Gg, Hh, Re, Hh^Qhh, Gg, Gs, Re, Gg, Gg, Cer^Edb, 3 Ker, Cer, Cer^Edb, Re, Re, Re
Gg^Qhh, Gs^Qhhf, Wo, Wo, Wo, Gll, Gll^Edt, Gg, Re, Rr, Re, Ch, Re, Gg, Rb^Gvs, Re^Gvs, Rb^Gvs, Rb^Gvs, Re, Rb^Gvs, Rb^Gvs, Rb^Gvs, Gs, Re, Gg, Gg, Mm^Qhh, Hh, Hhd, Hh, Gs, Re, Hhd, Hh, Gg, Gs^Ecf, Gg, Gg, Gg^Vhr, Gg, Hh^Qhh
Gg, Ww, Gll, Ww, Wo, Wo, Ww, Ww, Rb^Gvs, Re^Gvs, Rb^Gvs, Re, Re^Gvs, Re, Re, Rb^Gvs, Re, Rb^Gvs, Re, Rb^Gvs, Rb^Gvs, Rb^Gvs, Re, Gs, Hh, Hh^Qhh, Hh^Qhh, Mm^Qhh, Hh, Hh^Qhh, Hh^Qhh, Re, Gg, Gg, Gg, Gg, Gg, Gg, Hhd^Qhh, Hh, Hh^Qhh
Gs^Fds, Gg, Gd, Ww, Wo, Wo, Ww, Re^Gvs, Re^Gvs, Rb^Gvs, Rb^Gvs, Rb^Gvs, Re^Gvs, Re^Gvs, Gg, Re^Vh, Gg, Re, Re, Rb^Gvs, Gg, Re, Gs^Fms, Gs^Fds, Gs^Fms, Hh^Qhhf, Hh^Qhh, Mm, Mm, Mm, Mm, Mm^Qhh, Hh^Qhh, Hhd^Qhh, Ww, Ww, Ww, Hh^Qhh, Hh, Hhd, Mm^Qhh
Gs^Fms, Gs^Fms, Gg, Gd, Ww, Wo, Re^Gvs, Wwf, Re^Gvs, Re^Gvs, Rb^Gvs, Rb^Gvs, Gg^Eff, Rb, Gll^Fmw, Gll^Fmw, Gs^Fms, Re^Fmw, Gs^Vh, Re, Gg^Efm, Gs^Fms, Gs^Fds, Gs^Fds, Gs^Fms, Gs^Fms, Hh^Qhh, Mm^Qhh, Hh^Qhh, Mm, Mm, Mm, Mm^Qhh, Wwf, Wwf, Ww, Ww, Hh^Qhh, Mm, Mm, Mm^Qhh
Gs^Fms, Gs^Fms, Gs^Fds, Ww, Wo, Wo, Ww, Re^Gvs, Rb^Gvs, Rb^Gvs, Gg^Vwm, Rb^Eff, Gg^Eff, Gg, Re, Gs^Vl, Gs^Fms, Gll^Fmw, Gg^Es, Gg^Efm, Gll^Qhuf, Gs^Fms, Gll^Fmw, Gs^Qhuf, Gs^Fms, Gs^Fms, Gs^Fms, Hh^Qhh, Hh^Qhh, Hh^Qhh, Mm, Mm, Mm, Mm^Qhh, Mm^Qhh, Hh^Qhh, Hh^Qhh, Hh^Qhh, Hh, Mm, Hhd^Qhh
Gs^Fms, Gg, Wwf^Es, Ww, Ww, Ww, Ww, Gs^Fms, Re, Gll^Eff, Gg^Eff, Gg^Eff, Gs^Fms, Gg, Gg, Gg, Gg, Gg, Gg^Qhuf, Gs^Qhuf, Gs^Qhuf, Gg^Efm, Gg^Fmw, Gll^Fmw, Gg, Gs^Fms, Gs^Fms, Gll, Hh^Qhh, Mm, Mm, Mm, Mm, Mm, Mm, Hh, Hh, Hh, Hh, Hhd, Mm^Qhh
Rb, Re, Re, Wwf, Re, Ww, Ww, Wwf^Es, Gs^Fms, Gs^Fds, Gs, Gg^Edt, Gs^Fds, Gg, Gg, Re, Gg, Gg, Gs^Qhuf, Gs^Fms, Gs^Fds, Gll^Qhuf, Gll^Qhuf, Gs^Fms, Gs^Fms, Gs^Fms, Gs^Fms, Hh^Fms, Hh^Fms, Mm^Qhh, Mm, Hh^Edb, Hh^Fmw, Hh, Hh^Fms, Mm, Hh, Mm, Mm, Mm^Xm, Mm^Qhh
Gs^Fds, Gs^Fds, Gs^Fds, Rb, Gll^Fds, Re, Ww, Ww, Gs^Fms, Gs^Fms, Gll^Fmw, Gll^Fmw, Gs^Fds, Gs^Fds, Re, Re, Gg, Gs^Qhuf, Gs^Fms, Gs^Fds, Gg^_ml, Gs^Fms, Gll^Fmw, Gs^Fms, Gg^Fmw, Gs^Fms, Gs^Fms, Gs^Fms, Hh^Qhh, Hh^Qhh, Mm, Hh, Hh, Hh^Vhhr, Hh, Mm, Mm, Hh, Hh^Edb, Mm, Mm^Qhh
Gs^Fms, Gs^Fms, Gs^Fds, Gll, Wwr, Ww, Wo, Wwr, Gll^Fmw, Gg^Efm, Gll^Fmw, Gs^Fms, Gs^Fms, Gs^Fds, Gg, Rb, Rb, Gs^Qhuf, Gs^Qhuf, Gs^Qhuf, Gll^Qhuf, Gll^Fmw, Gll^Qhuf, Gg^Qhuf, Gs^Fms, Gs^Fms, Gs, Gs^Fms, Gs^Fms, Hh^Qhhf, Hh^Qhh, Mm, Mm, Gg, Gg, Gg, Hh, Mm, Mm, Mm, Hh^Qhh
Gg, Gs^Fds, Gg, Ww, Ww, Wo, Gg, Wwr, Gll^Fmw, Gll^Fmw, Gs^Fms, Rb, Gll^Fmw, Gs^Vl, Rb, Gg^Fmw, Gll^Fds, Re, Re, Gg, Gs^Qhuf, Gll^Qhuf, Gs, Gs^Fms, Gs^Fms, Gs^Fms, Re, Gs^Fms, Gs^Fms, Hh, Hh^Qhhf, Mm, Hh, Hh, Gs^_mhh, Gg^Vhr, Hh^Fmw, Hh, Mm, Mm, Hh^Qhh
Ww, Ww^Es, Ww, Ww, Wo, Wo, Gs^Fms, Gg, Gd, Rb, Gs^Fms, Gs^Fds, Gs^Fds, Gll^Fmw, Re, Gg, Gll^Fds, Gg^Efm, Re, Re, Gg^Qhuf, Re, Gll, Gll^Vl, Gs^Fds, Gs^Fms, Cer, Gs^Fms, Cer, Gs, Hh, Hh^Qhh, Mm, Mm, Hh^Fms, Mm, Mm, Hh^Fmw, Hh^Fms, Hh^Fms, Hh^Qhh
Gll^Qhhf, Gll^Qhhf, Gg^Qhh, Ww, Gs^Qhhf, Wo, Wo, Ww, Gs^Fms, Gll^Es, Ww^Es, Gs^Fds, Rb, Rb, Re, Gll^Fds, Re^Fds, Gs^Qhhf, Gg^Qhhf, Re, Re, Re, Gs, Gg, Gg, Gg, Cer, 4 Ker, Cer^Edb, Cer, Cer, Hh^Qhh, Mm, Mm, Mm, Hh^Fms, Mm, Mm, Mm, Mm, Mm^Qhh
Gll^Qhhf, Gll^Fp, Gll^Fp, Gll^Qhh, Gll^Fp, Gll^Qhh, Wwr, Wo, Wo, Wo, Gll^Fds, Gll, Gll^Fds, Re, Gll^Fds, Gll^Fds, Gg^Fmw, Gs^Efm, Gg^Fmw, Gg^Qhhf, Gg^Qhhf, Re, Re, Re, Gg, Cer^Edb, Cer, Gs^Ecf, Gs, Gs, Re, Hh^Qhh, Hh^Qhhf, Mm, Mm, Mm, Mm, Mm^Xm, Mm^Xm, Mm, Mm^Qhh
Gs^Qhhf, Gg^_mh, Gs^Fms, Gll^Fp, Gs^Fms, Gll^Qhhf, Gg^Qhh, Wo, Ww, Wo, Ww, Re, Re^Es, Re, Gll^Fds, Gs^Fms, Gll^Fmw, Gll^Fmw, Gll^Fms, Gs^Fms, Gg^Qhhf, Gs^Fds, Re, Gg, Gs^Fds, Gs, Re, Gs, Gs^Vl, Gs^Fds, Gs^Fms, Hh, Hh^Qhhf, Mm, Hh^Fms, Mm, Mm, Mm, Mm, Mm^Xm, Mm^Qhh
Gs^Qhhf, Gs^Fms, Gll^Fp, Gs^Fms, Gll^Fp, Gs^Efm, Gs^Fds, Gs^Qhhf, Ww, Gs^Fms, Gs^Fms, Rb, Re, Gs^Vl, Gll^Fds, Gll^Fds, Gll^Fmw, Gll^Fms, Gll^Fmw, Gg^Qhhf, Gll^Fmw, Gs^Fds, Re, Re, Hh^Fmw, Gs, Hhd, Re, Gs, Gs^Fds, Re, Gs^Fmw, Gs, Hh^Qhhf, Hh^Qhhf, Mm, Mm, Mm, Mm^Xm, Mm^Xm, Mm^Qhh
Gg^Qhhf, Gs^Qhhf, Gll^Qhhf, Gll^Qhhf, Gll^Qhhf, Gs^Qhhf, Gs^Qhhf, Gd^Qhh, Gll^Qhh, Wo, Gll^Fmw, Gs^Fds, Re, Gll^Fds, Gg^Qhhf, Gll^Fmw, Gll^Fmw, Gg, Gg^Qhh, Gg^Qhh, Gg^Qhh, Gg, Re, Hhd, Mm, Hh^Fds, Mm, Re, Re, Re, Re, Re, Gs, Gs, Gs^_mh, Hh^Qhh, Gs^Qhh, Mm, Mm^Qhh, Mm^Qhh, Mm^Qhh
